25 20
#############
#...........#    ########
#...s...s...######......#
#.......................#
#...........######......#
#.....s.....#    #.t.k..#
#.-.........#    #......#
#...........#    #......#
#####..######    ###..###
    #..#           #..#
    #..#           #..#
    #..#          ##dd##
  ###..####      #......#
  #..@....#      #......#
  #.......#      #......#
  #.......#      #......#
  #.......#      #......#
  #.......#      #......#
  #.......#      #......#
  #########       ######
