25 20
#############
#...........#    ########
#...s...s...######......#
#.....................k.#
#...........######......#
#.....s.....#    #......#
#.-.........#    #......#
#...........#    #......#
#####..######    ###..###
    #..#           #..#
    #..#           #..#
    #..#          ##dd##
  ###..####      #......#
  #.......#      #......#
  #.......#      #......#
  #.......#      #......#
  #.......#      #......#
  #.......#      #......#
  #...@...#      #......#
  #########       ######
